15 19
##   # * #   ##
#    # * #    #
#    # * #   !#
## D## * ##D ##
#%***********%#
#*         ~ *#
#*  #######  *#
#*  # *#* #  *#
#*    *#*    *#
#*  D @#3 %  *#
#*    *#*    *#
#*  # *#* #  *#
#*  #######  *#
#* ^        a*#
#%***********%#
## D## * ##D ##
#****# * #****#
#$ &*# * #*&  #
##  *# * #*  ##
