15 19
###**#####**###
#3 ****a**** %#
#  *   *   *  #
   *## * ##*   
** *#  * !#*~**
#***#  *  #***#
#####  *  #####
#***# *** #***#
**  ***#***  **
D*****###*****D
**  ***#***  **
#***#  *  #***#
#####  *  #####
#***#  *  #***#
** *#@ * &#* **
   *## * ##*   
#  *  ^*   *  #
#% ********* $#
###**#####**###
