15 19
###  *###*  ###
#  ~ **!** & %#
#    *   *    #
#####*   *#####
#*****#D#*****#
**   ## ##   **
**  ## * ##  **
#* ## *** ## *#
#*@## *3* ## *#
#*  ## * ##  *#
#*   ## ##   *#
#*    #D#    *#
**           **
***************
#* ###*a*### *#
#* #*** ***# *#
#* #*     *# *#
#%&#*  $  *#^*#
### * ### * ###
